SO       ./textures/south_texture.xpm      
NO ./textures/north_texture.xpm     
F   255 ,  2,  25
WE ./textures/west_texture.xpm    
EA ./textures/east_texture.xpm
C    100  , 200, 1     


  
     

      
         

 11111111111111
11111100000001
11100000000W11
11100001111111
1110000001 10011
11111111111111


















