SO       ./textures/south_texture.xpm      
NO ./textures/north_texture.xpm     
WE ./textures/west_texture.xpm    
EA ./textures/east_texture.xpm
C    100  , 200, 1     
F   255 ,  2,  25

      
        1111111111111111111111111
        1000000000110000000000001
        1011000001110000000000001
        100100000000000000001000111111
111111111011000001110000000000001    1
100000000011000001110111111111001  111
11110111111111011100000000001111111111
11110111111111011101010010001
11000000110101011100000010001
10000000000000001100000010001
10000000000000001101010010001
11000001110101011111011110E01
11110111 1110101 101111010001
11111111 1111111 111111111111

