SO       ./textures/south_texture.xpm        
NO ./textures/north_texture.xpm     
WE ./textures/west_texture.xpm    
F 255 ,  2,  0      






EA ./textures/east_texture.xpm
           



   1111111111111111111111111111111111111111111111111111111111111111
C    100  , 200, 1      
111111000000011111111011111111111111111111111111111111111111   
11100000000001                                                      
  111000011111111111111111111111111111111111111111111111111111            
111000000000N1
11111111111111


