SO       ./textures/south_texture.xpm      
NO ./textures/north_texture.xpm     
F   255 ,  2,  25
WE ./textures/west_texture.xpm    
EA ./textures/east_texture.xpm
C    100  , 200, 1     


  
     

      
         

111111111
110000E11
111111111


















