SO       ./textures/south_texture.xpm        
NO ./textures/north_texture.xpm     
WE ./textures/west_texture.xpm    
EA ./textures/east_texture.xpm
F 255 ,  2,  0      
C    100  , 200, 1     


  
     

      
         

   1111111111111111111111111111111111111111111111111111111111111111
111111000000011111111011111111111111111111111111111111111111   
11100000000W1                                                      
  111000011111111111111111111111111111111111111111111111111111            
1110000000001
11111111111111



 
  

  