SO ./textures/south_texture.xpm
NO ./textures/north_texture.xpm
WE ./textures/west_texture.xpm
EA ./textures/east_texture.xpm
C 100, 200, 1
F 255, 255, 255

   111111111111
11111100000001
11100000000001
  1110000111111
111000000000N1
11111111111111


