NO ./textures/north_texture.xpm
SO ./textures/south_texture.xpm
WE ./textures/west_texture.xpm
EA ./textures/east_texture.xpm
F 220,100,0
C 100,200,255

111111111111
100000000001
100000000001
100001100001
1000000000N1
111111111111
